NO textures/north.xpm
SO textures/south.xpm
WE textures/west.xpm
EA textures/east.xpm

F 35,35,40
C 120,170,210

1111111111
1000000001
1001110001
1001000001
10010N0001
1000000001
1111111111
