NO textures/north.xpm
SO textures/south.xpm
WE textures/west.xpm



EA textures/east.xpm


F 42,36,33
C 110,150,195

11111111111111111111
10000000000000000001
11111111111111111001
10000000000000001001
10011111111111101001
10010000000000101001
11111111111110101001
       1001010000001
11111111111010101111
10000101001010001E01
11111111111111111111
