NO textures/north.xpm
SO textures/south.xpm
WE textures/west.xpm
EA textures/east.xpm

F 30,42,45
C 100,165,205

11111111111111111
10000000100000001
10111110101111101
10000000100000001
11101111111110111
10000000W00000001
11101111111110111
10000000100000001
10111110101111101
10000000100000001
11111111111111111
