NO textures/north.xpm
SO textures/south.xpm
WE textures/west.xpm
EA textures/east.xpm

F 45,38,32
C 135,180,220

111111111111111
100000100000001
100000100011101
100000000010001
111011111010101
100010000000101
101010111110101
10100010S000001
100000100000001
111111111111111
