NO textures/north.xpm
SO textures/south.xpm
WE textures/west.xpm
EA textures/east.xpm

F 20,25,32
C 115,160,200

11111111111111111111
10000000010000000001
10111111010111111001
10000001010000001001
11111001011111001001
10001001000001001001
10101001111101001001
10101000000101000001
10101111110101111101
10000000000N00000001
11111111111111111111
