NO textures/north.xpm
SO textures/south.xpm
WE textures/west.xpm
EA textures/east.xpm

F 42,36,33
C 110,150,195

11111111111111111111
10000000000000000001
11111111111111111001
10000000000000001001
10011111111111101001
10010000000000101001
10010111111110101001
10010100000010101001
10010101111010101001
10000101001010000E01
11111111111111111111
