NO textures/north.xpm
SO textures/south.xpm
WE textures/west.xpm
EA textures/east.xpm

F 32,32,38
C 100,170,215

111111111111111111111111
100000000000100000000001
101111111110101111111101
101000000010100000000101
101011111010111110110101
101010001010000010010101
101010101011111010010101
100010101000001010000101
111110101111101011110101
100000100000001000010001
101111111111101111010111
101000000000000001010001
101011111111111101011101
101000000000000000000001
10000000000S000000000001
111111111111111111111111
