NO textures/north.xpm
SO textures/south.xpm
WE textures/west.xpm
EA textures/east.xpm

F 22,28,31
C 125,175,215

111111111111111111
100000000000000001
101111111111111101
101000000000000101
101011111111110101
101010000000010101
101010111111010101
101010100001010101
101010101101010101
101000100W01000101
101111111111111101
100000000000000001
111111111111111111
