NO textures/north.xpm
SO textures/south.xpm
WE textures/west.xpm
EA textures/east.xpm

F 38,34,30
C 105,155,205

1111111111111111111
1000000000000000001
1011011011011011001
1000000000000000001
1011011011011011001
10000000N0000000001
1011011011011011001
1000000000000000001
1011011011011011001
1000000000000000001
1111111111111111111
