NO textures/north.xpm
SO textures/south.xpm
WE textures/west.xpm
EA textures/east.xpm

F 28,28,34
C 90,135,185

1111111111111111111111
1000000000010000000001
1011111111010111111101
1010000000010100000101
1010111111110101110101
1010100000000001010101
1010101111111101010101
1000101000000101000101
1111101011110101111101
1000001000010100000001
1011111111010111111101
10000000000E0000000001
1111111111111111111111
