NO textures/north.xpm
SO textures/south.xpm
WE textures/west.xpm
EA textures/east.xpm

F 50,45,40
C 130,185,225

111111111111111111
100000000000000001
100011100111000001
100010000001000001
100010111101000001
100000100100000001
10000010S100000001
100000100100000001
100010111101000001
100010000001000001
100011100111000001
100000000000000001
111111111111111111
