NO textures/north.xpm
SO textures/south.xpm
WE textures/west.xpm
EA textures/east.xpm

F 25,30,35
C 95,145,190

111111111111111111
100000000000000001
101111011111011101
100001000001000001
111101111101111101
100000000E00000001
101111011111011101
100000000000000001
111111111111111111
